,Date,Price (USD per Barrel),SLB Price (USD),SP500 Price (USD),Month,Latin America,Europe,Africa,Middle East,Asia Pacific,Total Intl.,Canada,U.S.,Total World,Year
0,1986-01-01,22.93,8.34,211.78,Jan,421,237,121,200,269,1248,437,1810,3495,1986
1,1986-02-01,15.46,7.5,226.92,Feb,411,232,113,202,267,1225,454,1444,3123,1986
2,1986-03-01,12.61,7.94,238.9,Mar,405,233,104,198,255,1195,347,1139,2681,1986
3,1986-04-01,12.84,7.5,235.52,Apr,401,229,101,194,247,1172,66,906,2144,1986
4,1986-05-01,15.38,8.09,247.35,May,393,199,92,193,241,1118,39,781,1938,1986
5,1986-06-01,13.43,8.59,250.84,Jun,386,179,92,185,240,1082,64,705,1851,1986
6,1986-07-01,11.59,7.19,236.12,Jul,343,170,92,174,237,1016,70,686,1772,1986
7,1986-08-01,15.1,8.5,252.93,Aug,337,160,90,169,235,991,102,730,1823,1986
8,1986-09-01,14.87,8.44,231.32,Sep,335,147,89,164,234,969,102,755,1826,1986
9,1986-10-01,14.9,8.0,243.98,Oct,343,139,89,161,245,977,107,819,1903,1986
10,1986-11-01,15.22,8.31,249.22,Nov,330,138,79,159,238,944,114,899,1957,1986
11,1986-12-01,16.11,7.94,242.17,Dec,318,132,86,152,242,930,239,963,2132,1986
12,1987-01-01,18.65,9.09,274.08,Jan,325,136,89,149,242,941,284,900,2125,1987
13,1987-02-01,17.75,9.41,284.2,Feb,337,136,89,146,245,953,138,818,1909,1987
14,1987-03-01,18.3,10.09,291.7,Mar,331,130,90,157,241,949,168,772,1889,1987
15,1987-04-01,18.68,10.22,288.36,Apr,331,139,93,158,247,968,60,754,1782,1987
16,1987-05-01,19.44,10.62,290.1,May,331,137,94,156,243,961,61,763,1785,1987
17,1987-06-01,20.07,11.44,304.0,Jun,337,139,92,149,252,969,122,788,1879,1987
18,1987-07-01,21.34,12.38,318.66,Jul,334,146,96,143,246,965,161,901,2027,1987
19,1987-08-01,20.31,11.84,329.8,Aug,335,163,89,150,244,981,182,1003,2166,1987
20,1987-09-01,19.53,11.69,321.83,Sep,339,159,94,154,241,987,248,1101,2336,1987
21,1987-10-01,19.86,8.75,251.79,Oct,345,174,88,146,245,998,274,1124,2396,1987
22,1987-11-01,18.85,7.41,230.3,Nov,343,188,94,151,258,1034,275,1152,2461,1987
23,1987-12-01,17.28,7.19,247.08,Dec,354,193,87,156,261,1051,198,1162,2411,1987
24,1988-01-01,17.13,8.16,257.07,Jan,342,180,83,154,258,1017,190,1076,2283,1988
25,1988-02-01,16.8,8.72,267.82,Feb,342,180,84,155,264,1025,312,976,2313,1988
26,1988-03-01,16.2,8.59,258.89,Mar,343,177,91,157,269,1037,313,951,2301,1988
27,1988-04-01,17.86,9.38,261.33,Apr,340,170,95,163,265,1033,102,917,2052,1988
28,1988-05-01,17.42,9.34,262.16,May,338,169,101,155,262,1025,147,891,2063,1988
29,1988-06-01,16.53,8.38,273.5,Jun,343,174,98,152,260,1027,190,897,2114,1988
30,1988-07-01,15.5,8.62,272.02,Jul,333,172,92,155,280,1032,177,912,2121,1988
31,1988-08-01,15.52,8.22,261.52,Aug,323,172,99,158,277,1029,185,930,2144,1988
32,1988-09-01,14.54,8.44,271.91,Sep,330,173,91,164,276,1034,257,927,2218,1988
33,1988-10-01,13.77,8.47,278.97,Oct,333,160,93,162,281,1029,193,923,2145,1988
34,1988-11-01,14.14,8.34,273.7,Nov,329,153,98,259,274,1113,154,918,2185,1988
35,1988-12-01,16.38,8.16,277.72,Dec,329,151,85,171,241,977,130,924,2031,1988
36,1989-01-01,18.02,9.0,297.47,Jan,313,147,88,167,276,991,123,841,1955,1989
37,1989-02-01,17.94,8.84,288.86,Feb,319,155,92,168,274,1008,187,762,1957,1989
38,1989-03-01,19.48,9.5,294.87,Mar,270,151,81,172,271,945,221,753,1919,1989
39,1989-04-01,21.07,9.84,309.64,Apr,262,154,79,165,266,926,105,771,1802,1989
40,1989-05-01,20.12,9.84,320.52,May,258,158,76,154,272,918,63,754,1735,1989
41,1989-06-01,20.05,9.94,317.98,Jun,246,152,77,148,266,889,103,795,1787,1989
42,1989-07-01,19.78,10.59,346.08,Jul,238,146,80,161,272,897,103,832,1832,1989
43,1989-08-01,18.58,11.09,351.45,Aug,234,142,73,157,271,877,103,886,1866,1989
44,1989-09-01,19.59,10.69,349.15,Sep,239,146,85,158,263,891,105,955,1951,1989
45,1989-10-01,20.1,10.66,340.36,Oct,239,142,80,160,277,898,138,984,2020,1989
46,1989-11-01,19.86,11.66,345.99,Nov,234,139,90,160,272,895,143,1041,2079,1989
47,1989-12-01,21.1,12.28,353.4,Dec,229,144,91,162,274,900,162,1065,2127,1989
48,1990-01-01,22.86,11.81,329.08,Jan,230,155,95,168,273,921,154,998,2073,1990
49,1990-02-01,22.11,11.84,331.89,Feb,241,151,89,164,272,917,221,911,2049,1990
50,1990-03-01,20.39,13.12,339.94,Mar,250,152,92,164,272,930,219,905,2054,1990
51,1990-04-01,18.43,12.53,330.8,Apr,252,173,93,148,267,933,79,935,1947,1990
52,1990-05-01,18.2,14.59,361.23,May,247,168,90,152,280,937,66,961,1964,1990
53,1990-06-01,16.7,14.38,358.02,Jun,249,172,95,155,276,947,91,999,2037,1990
54,1990-07-01,18.45,16.34,356.15,Jul,238,155,90,141,278,902,117,1010,2029,1990
55,1990-08-01,27.31,16.0,322.56,Aug,233,153,88,143,269,886,114,987,1987,1990
56,1990-09-01,33.51,15.22,306.05,Sep,242,155,85,100,272,854,108,1042,2004,1990
57,1990-10-01,36.04,13.94,304.0,Oct,242,156,91,102,275,866,130,1073,2069,1990
58,1990-11-01,32.33,14.19,322.22,Nov,263,157,93,105,282,900,165,1137,2202,1990
59,1990-12-01,27.28,14.47,330.22,Dec,266,153,94,104,272,889,189,1136,2214,1990
60,1991-01-01,25.23,14.44,343.93,Jan,272,149,90,101,256,868,205,1068,2141,1991
61,1991-02-01,20.48,15.88,367.07,Feb,269,148,88,106,246,857,243,984,2084,1991
62,1991-03-01,19.9,14.56,375.22,Mar,252,193,89,105,272,911,209,925,2045,1991
63,1991-04-01,20.83,15.47,375.34,Apr,261,193,98,110,265,927,58,854,1839,1991
64,1991-05-01,21.23,16.03,389.83,May,261,177,93,112,262,905,62,819,1786,1991
65,1991-06-01,20.19,14.72,371.16,Jun,272,178,91,112,261,914,87,867,1868,1991
66,1991-07-01,21.4,17.5,387.81,Jul,274,178,91,115,263,921,96,844,1861,1991
67,1991-08-01,21.69,18.19,395.43,Aug,286,167,89,120,255,917,102,803,1822,1991
68,1991-09-01,21.89,16.88,387.86,Sep,271,160,84,120,249,884,96,775,1755,1991
69,1991-10-01,23.23,17.38,392.45,Oct,288,153,89,132,266,928,98,795,1821,1991
70,1991-11-01,22.46,15.25,375.22,Nov,297,157,88,137,266,945,95,808,1848,1991
71,1991-12-01,19.5,15.59,417.09,Dec,292,137,87,142,272,930,105,796,1831,1991
72,1992-01-01,18.79,14.88,408.78,Jan,272,136,79,151,266,904,129,710,1743,1992
73,1992-02-01,19.01,15.0,412.7,Feb,265,136,78,149,266,894,131,669,1694,1992
74,1992-03-01,18.92,13.97,403.69,Mar,267,135,77,149,253,881,86,648,1615,1992
75,1992-04-01,20.23,15.53,414.95,Apr,277,134,78,156,230,875,32,642,1549,1992
76,1992-05-01,20.98,16.44,415.35,May,257,145,76,150,243,871,48,638,1557,1992
77,1992-06-01,22.39,15.72,408.14,Jun,250,145,78,152,244,869,62,621,1552,1992
78,1992-07-01,21.78,16.66,424.21,Jul,250,131,83,150,250,864,76,676,1616,1992
79,1992-08-01,21.34,17.22,414.03,Aug,251,129,84,152,229,845,94,686,1625,1992
80,1992-09-01,21.88,16.91,417.8,Sep,234,130,78,150,229,821,87,717,1625,1992
81,1992-10-01,21.69,15.88,418.68,Oct,236,126,68,152,232,814,104,803,1721,1992
82,1992-11-01,20.34,15.25,431.35,Nov,232,132,75,159,237,835,136,882,1853,1992
83,1992-12-01,19.41,14.31,435.71,Dec,210,131,69,165,233,808,164,926,1898,1992
84,1993-01-01,19.03,14.47,438.78,Jan,195,102,69,160,232,758,179,824,1761,1993
85,1993-02-01,20.09,14.91,443.38,Feb,192,110,72,157,232,763,239,684,1686,1993
86,1993-03-01,20.32,14.88,451.67,Mar,187,117,77,162,229,772,239,611,1622,1993
87,1993-04-01,20.25,16.0,440.19,Apr,203,118,71,158,238,788,83,612,1483,1993
88,1993-05-01,19.95,16.31,450.19,May,204,117,67,162,235,785,103,637,1525,1993
89,1993-06-01,19.09,15.84,450.53,Jun,205,108,65,158,233,769,187,695,1651,1993
90,1993-07-01,17.89,15.91,448.13,Jul,201,109,64,159,235,768,159,741,1668,1993
91,1993-08-01,18.01,16.84,463.56,Aug,202,111,67,155,230,765,170,797,1732,1993
92,1993-09-01,17.5,16.66,458.93,Sep,202,115,67,157,229,770,177,848,1795,1993
93,1993-10-01,18.15,15.78,467.83,Oct,209,119,71,156,233,788,199,860,1847,1993
94,1993-11-01,16.61,14.38,461.79,Nov,213,111,71,153,240,788,225,868,1881,1993
95,1993-12-01,14.52,14.78,466.45,Dec,217,110,71,154,215,767,257,857,1881,1993
96,1994-01-01,15.03,14.84,481.61,Jan,209,119,64,157,219,768,300,789,1857,1994
97,1994-02-01,14.78,14.22,467.14,Feb,212,108,63,142,223,748,324,754,1826,1994
98,1994-03-01,14.68,13.22,445.77,Mar,206,106,66,145,210,733,270,735,1738,1994
99,1994-04-01,16.42,13.75,450.91,Apr,230,113,64,138,206,751,120,723,1594,1994
100,1994-05-01,17.89,14.31,456.5,May,237,104,67,130,199,737,157,716,1610,1994
101,1994-06-01,19.06,14.78,444.27,Jun,230,104,69,110,215,728,232,756,1716,1994
102,1994-07-01,19.66,14.75,458.26,Jul,231,105,62,108,213,719,264,771,1754,1994
103,1994-08-01,18.38,14.25,475.49,Aug,240,98,60,113,198,709,280,766,1755,1994
104,1994-09-01,17.45,13.59,462.71,Sep,244,106,65,115,193,723,292,809,1824,1994
105,1994-10-01,17.72,14.72,472.35,Oct,252,104,63,113,191,723,280,822,1825,1994
106,1994-11-01,18.07,13.28,453.69,Nov,253,109,62,113,198,735,306,835,1876,1994
107,1994-12-01,17.16,12.59,459.27,Dec,255,103,69,123,181,731,287,816,1834,1994
108,1995-01-01,18.04,13.19,470.42,Jan,267,106,68,127,187,755,333,748,1836,1995
109,1995-02-01,18.57,14.22,487.39,Feb,266,99,65,129,190,749,364,713,1826,1995
110,1995-03-01,18.54,14.91,500.71,Mar,266,105,65,126,184,746,284,665,1695,1995
111,1995-04-01,19.9,15.72,514.71,Apr,271,106,65,128,189,759,84,678,1521,1995
112,1995-05-01,19.74,16.25,533.4,May,255,113,57,128,187,740,126,685,1551,1995
113,1995-06-01,18.45,15.53,544.75,Jun,284,114,70,128,188,784,227,674,1685,1995
114,1995-07-01,17.33,16.75,562.06,Jul,282,116,66,122,175,761,232,723,1716,1995
115,1995-08-01,18.02,16.12,561.88,Aug,278,113,64,124,181,760,205,745,1710,1995
116,1995-09-01,18.23,16.34,584.41,Sep,273,111,67,126,176,753,224,765,1742,1995
117,1995-10-01,17.43,15.56,581.5,Oct,276,115,61,130,172,754,213,754,1728,1995
118,1995-11-01,17.99,15.88,605.37,Nov,270,123,70,133,168,764,211,772,1747,1995
119,1995-12-01,19.03,17.31,615.93,Dec,271,128,77,135,172,783,251,763,1797,1995
120,1996-01-01,18.86,17.53,636.02,Jan,270,127,76,134,167,774,344,709,1827,1996
121,1996-02-01,19.09,18.22,640.43,Feb,278,116,75,127,171,767,374,700,1841,1996
122,1996-03-01,21.33,19.78,645.5,Mar,296,118,78,133,174,799,306,714,1819,1996
123,1996-04-01,23.5,22.06,654.17,Apr,294,123,76,133,169,795,84,741,1620,1996
124,1996-05-01,21.17,20.84,669.12,May,281,130,74,134,174,793,120,764,1677,1996
125,1996-06-01,20.42,21.06,670.63,Jun,282,119,79,139,174,793,245,774,1812,1996
126,1996-07-01,21.3,20.0,639.95,Jul,283,126,76,138,192,815,291,784,1890,1996
127,1996-08-01,21.9,21.09,651.99,Aug,280,114,82,135,179,790,285,811,1886,1996
128,1996-09-01,23.97,21.12,687.33,Sep,282,117,82,144,174,799,250,811,1860,1996
129,1996-10-01,24.88,24.78,705.27,Oct,285,106,78,137,179,785,281,836,1902,1996
130,1996-11-01,23.71,26.06,757.02,Nov,281,120,83,138,177,799,327,832,1958,1996
131,1996-12-01,25.23,24.97,740.74,Dec,277,123,85,139,186,810,343,852,2005,1996
132,1997-01-01,25.13,27.78,786.16,Jan,284,126,83,142,174,809,401,822,2032,1997
133,1997-02-01,22.18,25.16,790.82,Feb,283,121,83,142,180,809,409,849,2067,1997
134,1997-03-01,20.97,26.81,757.12,Mar,274,117,79,143,182,795,375,897,2067,1997
135,1997-04-01,19.7,27.69,801.34,Apr,271,117,83,155,178,804,209,901,1914,1997
136,1997-05-01,20.82,29.78,848.28,May,283,105,85,155,183,811,234,924,1969,1997
137,1997-06-01,19.26,31.25,885.14,Jun,278,114,79,163,188,822,323,976,2121,1997
138,1997-07-01,19.66,38.19,954.31,Jul,269,111,82,174,190,826,373,969,2168,1997
139,1997-08-01,19.95,38.09,899.47,Aug,268,107,75,173,188,811,411,993,2215,1997
140,1997-09-01,19.8,42.09,947.28,Sep,273,104,77,163,174,791,411,1009,2211,1997
141,1997-10-01,21.33,43.75,914.62,Oct,279,109,79,165,175,807,421,996,2224,1997
142,1997-11-01,20.19,41.16,955.4,Nov,274,111,81,164,172,802,445,983,2230,1997
143,1997-12-01,18.33,40.25,970.43,Dec,287,115,78,166,173,819,486,1013,2318,1997
144,1998-01-01,16.72,36.84,980.28,Jan,276,109,82,165,187,819,481,993,2293,1998
145,1998-02-01,16.06,37.81,1049.34,Feb,269,114,81,165,180,809,507,974,2290,1998
146,1998-03-01,15.12,37.88,1101.75,Mar,271,102,82,165,186,806,390,932,2128,1998
147,1998-04-01,15.35,41.5,1111.75,Apr,266,105,83,169,182,805,128,886,1819,1998
148,1998-05-01,14.91,39.03,1090.82,May,258,98,86,169,187,798,157,855,1810,1998
149,1998-06-01,13.72,34.16,1133.84,Jun,260,107,79,164,180,790,238,854,1882,1998
150,1998-07-01,14.17,30.28,1120.67,Jul,241,86,68,171,165,731,217,816,1764,1998
151,1998-08-01,13.47,21.91,957.28,Aug,227,91,67,169,168,722,211,792,1725,1998
152,1998-09-01,15.03,25.44,1017.01,Sep,219,108,61,170,174,732,187,774,1693,1998
153,1998-10-01,14.46,26.25,1098.67,Oct,209,91,67,160,159,686,153,734,1573,1998
154,1998-11-01,13.0,22.34,1163.63,Nov,212,87,68,164,158,689,201,688,1578,1998
155,1998-12-01,11.35,23.19,1229.23,Dec,213,85,62,160,151,671,248,647,1566,1998
156,1999-01-01,12.52,23.81,1279.64,Jan,193,91,58,145,148,635,341,587,1563,1999
157,1999-02-01,12.01,24.28,1238.33,Feb,178,81,52,150,151,612,332,542,1486,1999
158,1999-03-01,14.68,30.09,1286.37,Mar,170,89,50,146,158,613,198,526,1337,1999
159,1999-04-01,17.31,31.94,1335.18,Apr,178,86,41,143,150,598,62,496,1156,1999
160,1999-05-01,17.72,30.09,1301.84,May,190,82,37,140,142,591,64,516,1171,1999
161,1999-06-01,17.92,31.84,1372.71,Jun,187,94,40,137,144,602,187,558,1347,1999
162,1999-07-01,20.1,30.28,1328.72,Jul,179,80,38,141,143,581,215,588,1384,1999
163,1999-08-01,21.28,33.34,1320.41,Aug,184,74,40,137,121,556,270,639,1465,1999
164,1999-09-01,23.8,31.16,1282.71,Sep,190,77,36,130,124,557,275,696,1528,1999
165,1999-10-01,22.69,30.28,1362.93,Oct,195,66,38,134,132,565,289,741,1595,1999
166,1999-11-01,25.0,30.35,1388.91,Nov,199,77,36,136,127,575,336,782,1693,1999
167,1999-12-01,26.1,28.06,1469.25,Dec,196,74,38,139,127,574,385,798,1757,1999
168,2000-01-01,27.26,30.53,1394.46,Jan,186,65,39,140,130,560,502,775,1837,2000
169,2000-02-01,29.37,36.93,1366.42,Feb,183,72,38,141,128,562,544,763,1869,2000
170,2000-03-01,29.84,38.25,1498.58,Mar,199,82,45,149,131,606,394,773,1773,2000
171,2000-04-01,25.72,38.28,1452.43,Apr,199,79,42,153,129,602,146,805,1553,2000
172,2000-05-01,28.79,36.78,1420.6,May,215,76,46,156,134,627,189,844,1660,2000
173,2000-06-01,31.82,37.31,1454.6,Jun,225,90,46,159,137,657,291,878,1826,2000
174,2000-07-01,29.7,36.96,1430.83,Jul,233,85,45,160,139,662,308,942,1912,2000
175,2000-08-01,31.26,42.67,1517.68,Aug,249,90,50,164,152,705,319,987,2011,2000
176,2000-09-01,33.88,41.16,1436.51,Sep,259,95,47,158,155,714,314,1011,2039,2000
177,2000-10-01,33.11,38.06,1429.4,Oct,265,96,50,162,154,727,353,1055,2135,2000
178,2000-11-01,34.42,31.0,1314.95,Nov,257,80,49,165,149,700,362,1067,2129,2000
179,2000-12-01,28.44,39.97,1320.28,Dec,257,89,49,164,146,705,410,1097,2212,2000
180,2001-01-01,29.59,38.4,1366.01,Jan,253,87,52,180,145,717,539,1118,2374,2001
181,2001-02-01,29.61,31.88,1239.94,Feb,264,90,52,174,152,732,562,1136,2430,2001
182,2001-03-01,27.25,28.8,1160.33,Mar,267,90,52,164,149,722,445,1164,2331,2001
183,2001-04-01,27.49,33.15,1249.46,Apr,270,89,60,169,154,742,217,1206,2165,2001
184,2001-05-01,28.63,31.52,1255.82,May,268,98,55,174,157,752,238,1234,2224,2001
185,2001-06-01,27.6,26.32,1224.38,Jun,265,99,57,179,160,760,302,1271,2333,2001
186,2001-07-01,26.43,26.88,1211.23,Jul,262,98,55,181,152,748,319,1278,2345,2001
187,2001-08-01,27.37,24.5,1133.58,Aug,265,90,52,189,160,756,325,1252,2333,2001
188,2001-09-01,26.2,22.85,1040.94,Sep,266,100,52,187,161,766,317,1193,2276,2001
189,2001-10-01,22.17,24.21,1059.78,Oct,252,101,52,178,167,750,304,1111,2165,2001
190,2001-11-01,19.64,24.0,1139.45,Nov,253,99,49,182,158,741,266,1000,2007,2001
191,2001-12-01,19.39,27.48,1148.08,Dec,255,99,45,188,165,752,264,901,1917,2001
192,2002-01-01,19.72,28.2,1130.2,Jan,230,106,50,187,171,744,405,867,2016,2002
193,2002-02-01,20.72,29.11,1106.73,Feb,223,84,54,192,163,716,433,825,1974,2002
194,2002-03-01,24.53,29.41,1147.39,Mar,221,93,60,199,161,734,311,763,1808,2002
195,2002-04-01,26.18,27.38,1076.92,Apr,200,101,60,197,168,726,121,750,1597,2002
196,2002-05-01,27.04,25.82,1067.14,May,200,94,56,196,172,718,114,826,1658,2002
197,2002-06-01,25.52,23.25,989.82,Jun,216,87,54,201,172,730,205,843,1778,2002
198,2002-07-01,26.97,21.46,911.62,Jul,199,78,55,201,172,705,266,851,1822,2002
199,2002-08-01,28.39,21.61,916.07,Aug,206,79,60,203,174,722,235,848,1805,2002
200,2002-09-01,29.66,19.23,815.28,Sep,207,81,63,206,170,727,250,860,1837,2002
201,2002-10-01,28.84,20.05,885.76,Oct,212,83,63,214,174,746,220,852,1818,2002
202,2002-11-01,26.35,22.12,936.31,Nov,230,88,59,210,173,760,281,834,1875,2002
203,2002-12-01,29.46,21.05,879.82,Dec,219,83,56,211,184,753,348,856,1957,2002
204,2003-01-01,32.95,18.85,855.7,Jan,211,84,53,210,176,734,478,854,2066,2003
205,2003-02-01,35.83,20.8,841.15,Feb,215,83,55,219,180,752,554,907,2213,2003
206,2003-03-01,33.51,19.0,848.18,Mar,226,79,55,210,177,747,449,941,2137,2003
207,2003-04-01,28.17,20.96,916.92,Apr,238,83,60,207,182,770,151,983,1904,2003
208,2003-05-01,28.11,24.31,963.59,May,238,81,54,209,173,755,150,1035,1940,2003
209,2003-06-01,30.66,23.79,974.5,Jun,245,86,58,208,172,769,308,1067,2144,2003
210,2003-07-01,30.76,22.54,993.32,Jul,250,90,48,211,176,775,398,1081,2254,2003
211,2003-08-01,31.57,24.75,1008.01,Aug,250,88,52,209,180,779,404,1090,2273,2003
212,2003-09-01,28.31,24.2,995.97,Sep,259,87,50,215,181,792,348,1093,2233,2003
213,2003-10-01,30.34,23.48,1050.71,Oct,266,80,51,209,184,790,394,1102,2286,2003
214,2003-11-01,31.11,23.46,1058.2,Nov,269,77,51,212,171,780,412,1112,2304,2003
215,2003-12-01,32.13,27.36,1111.92,Dec,264,83,62,217,177,803,417,1114,2334,2003
216,2004-01-01,34.31,30.59,1131.13,Jan,273,69,48,222,190,802,554,1101,2457,2004
217,2004-02-01,34.69,32.24,1144.94,Feb,269,73,48,216,184,790,568,1119,2477,2004
218,2004-03-01,36.74,31.93,1126.21,Mar,278,79,41,218,183,799,462,1136,2397,2004
219,2004-04-01,36.75,29.27,1107.3,Apr,285,80,46,226,195,832,153,1151,2136,2004
220,2004-05-01,40.28,28.59,1120.68,May,293,71,51,225,199,839,187,1164,2190,2004
221,2004-06-01,38.03,31.75,1140.84,Jun,292,76,50,226,197,841,265,1176,2282,2004
222,2004-07-01,40.78,32.16,1101.72,Jul,286,58,50,222,201,817,351,1213,2381,2004
223,2004-08-01,44.9,30.9,1104.24,Aug,295,65,49,237,210,856,353,1234,2443,2004
224,2004-09-01,45.94,33.66,1114.58,Sep,294,63,49,248,212,866,273,1240,2379,2004
225,2004-10-01,53.28,31.47,1130.2,Oct,296,70,47,235,194,842,372,1240,2454,2004
226,2004-11-01,48.47,32.81,1173.82,Nov,317,69,49,239,202,876,447,1262,2585,2004
227,2004-12-01,43.15,33.48,1211.92,Dec,306,63,53,247,200,869,440,1246,2555,2004
228,2005-01-01,46.84,34.02,1181.27,Jan,307,57,50,242,204,860,550,1255,2665,2005
229,2005-02-01,48.15,37.73,1203.6,Feb,317,54,53,232,220,876,593,1276,2745,2005
230,2005-03-01,54.19,35.24,1180.59,Mar,314,71,51,246,209,891,420,1306,2617,2005
231,2005-04-01,52.98,34.2,1156.85,Apr,320,66,52,246,214,898,183,1334,2415,2005
232,2005-05-01,49.83,34.19,1191.5,May,330,72,46,245,226,919,247,1319,2485,2005
233,2005-06-01,56.35,37.97,1191.33,Jun,328,78,53,248,225,932,293,1355,2580,2005
234,2005-07-01,59.0,41.87,1234.18,Jul,318,80,46,241,226,911,450,1398,2759,2005
235,2005-08-01,64.99,43.12,1220.33,Aug,308,76,49,248,233,914,545,1435,2894,2005
236,2005-09-01,65.59,42.19,1228.81,Sep,307,67,52,246,235,907,497,1452,2856,2005
237,2005-10-01,62.26,45.38,1207.01,Oct,295,70,46,259,233,903,541,1479,2923,2005
238,2005-11-01,58.32,47.87,1249.48,Nov,318,75,49,256,237,935,600,1486,3021,2005
239,2005-12-01,59.41,48.58,1248.29,Dec,327,74,49,262,236,948,575,1470,2993,2005
240,2006-01-01,65.49,63.73,1280.08,Jan,323,81,47,210,244,905,660,1473,3038,2006
241,2006-02-01,61.63,57.5,1280.66,Feb,309,85,49,212,230,885,715,1533,3133,2006
242,2006-03-01,62.69,63.28,1294.83,Mar,306,80,58,221,233,898,620,1551,3069,2006
243,2006-04-01,69.44,69.14,1310.61,Apr,327,81,56,226,222,912,198,1597,2707,2006
244,2006-05-01,70.84,65.57,1270.09,May,333,86,50,229,222,920,240,1635,2795,2006
245,2006-06-01,70.95,65.11,1270.2,Jun,328,78,48,235,217,906,408,1665,2979,2006
246,2006-07-01,74.41,66.85,1276.66,Jul,323,71,59,242,226,921,553,1681,3155,2006
247,2006-08-01,73.04,61.3,1303.82,Aug,326,81,63,256,228,954,482,1738,3174,2006
248,2006-09-01,63.8,62.03,1335.85,Sep,332,76,64,253,224,949,446,1739,3134,2006
249,2006-10-01,58.89,63.08,1377.94,Oct,330,80,68,257,230,965,431,1734,3130,2006
250,2006-11-01,59.08,68.48,1400.63,Nov,318,65,69,259,228,939,432,1706,3077,2006
251,2006-12-01,61.96,63.16,1418.3,Dec,329,65,67,255,235,951,456,1718,3125,2006
252,2007-01-01,54.51,63.49,1438.24,Jan,335,74,69,263,231,972,568,1714,3254,2007
253,2007-02-01,59.28,62.8,1406.82,Feb,360,74,64,252,231,981,635,1736,3352,2007
254,2007-03-01,60.44,69.1,1420.86,Mar,365,77,65,260,227,994,392,1749,3135,2007
255,2007-04-01,63.98,73.83,1482.37,Apr,349,87,60,248,240,984,101,1751,2836,2007
256,2007-05-01,63.46,77.87,1530.62,May,350,88,60,268,241,1007,107,1748,2862,2007
257,2007-06-01,67.49,84.94,1503.35,Jun,366,66,65,269,249,1015,210,1771,2996,2007
258,2007-07-01,74.12,94.72,1455.27,Jul,360,79,60,275,244,1018,349,1777,3144,2007
259,2007-08-01,72.36,96.5,1473.99,Aug,348,82,68,270,241,1009,343,1804,3156,2007
260,2007-09-01,79.92,105.0,1526.75,Sep,363,77,73,273,246,1032,351,1783,3166,2007
261,2007-10-01,85.8,96.57,1549.38,Oct,355,82,69,268,250,1024,338,1762,3124,2007
262,2007-11-01,94.77,93.45,1481.14,Nov,340,71,69,265,247,992,371,1798,3161,2007
263,2007-12-01,91.69,98.37,1468.36,Dec,370,77,74,274,241,1036,360,1811,3207,2007
264,2008-01-01,92.97,75.4,1378.55,Jan,365,93,68,275,252,1053,494,1749,3296,2008
265,2008-02-01,95.39,86.45,1330.63,Feb,373,81,58,272,248,1032,620,1765,3417,2008
266,2008-03-01,105.45,87.0,1322.7,Mar,380,100,70,269,235,1054,408,1797,3259,2008
267,2008-04-01,112.58,100.55,1385.59,Apr,380,93,73,279,249,1074,106,1829,3009,2008
268,2008-05-01,125.4,101.13,1400.38,May,367,101,66,278,263,1075,135,1863,3073,2008
269,2008-06-01,133.88,107.43,1280.0,Jun,398,97,65,277,265,1102,266,1901,3269,2008
270,2008-07-01,133.37,101.6,1267.38,Jul,379,107,63,280,263,1092,412,1932,3436,2008
271,2008-08-01,116.67,94.22,1282.83,Aug,382,97,62,289,257,1087,449,1987,3523,2008
272,2008-09-01,104.11,78.09,1166.36,Sep,398,99,68,291,252,1108,435,2014,3557,2008
273,2008-10-01,76.61,51.65,968.75,Oct,403,101,60,288,244,1096,446,1976,3518,2008
274,2008-11-01,57.31,50.74,896.24,Nov,397,107,59,280,253,1096,417,1935,3448,2008
275,2008-12-01,41.12,42.33,903.25,Dec,389,101,67,279,242,1078,361,1782,3221,2008
276,2009-01-01,41.71,40.81,825.88,Jan,381,93,58,274,238,1044,377,1553,2974,2009
277,2009-02-01,39.09,38.06,735.09,Feb,374,81,59,264,242,1020,413,1320,2753,2009
278,2009-03-01,47.94,40.62,797.87,Mar,358,95,61,262,236,1012,196,1105,2313,2009
279,2009-04-01,49.65,48.99,872.81,Apr,349,86,62,253,236,986,74,995,2055,2009
280,2009-05-01,59.03,57.23,919.14,May,357,82,62,253,239,993,72,918,1983,2009
281,2009-06-01,69.64,54.11,919.32,Jun,343,77,64,247,236,967,125,895,1987,2009
282,2009-07-01,64.15,53.5,987.48,Jul,351,73,57,249,244,974,175,931,2080,2009
283,2009-08-01,71.05,56.2,1020.62,Aug,344,78,58,234,233,947,178,980,2105,2009
284,2009-09-01,69.41,59.6,1057.08,Sep,355,83,57,245,246,986,208,1009,2203,2009
285,2009-10-01,75.72,62.2,1036.19,Oct,351,84,62,239,247,983,244,1044,2271,2009
286,2009-11-01,77.99,63.89,1095.63,Nov,361,86,68,253,257,1025,277,1107,2409,2009
287,2009-12-01,74.47,65.09,1115.1,Dec,353,84,70,251,266,1024,313,1172,2509,2009
288,2010-01-01,78.33,63.46,1073.87,Jan,374,86,74,260,253,1047,459,1267,2773,2010
289,2010-02-01,76.39,61.1,1104.49,Feb,382,85,84,258,259,1068,564,1350,2982,2010
290,2010-03-01,81.2,63.46,1169.43,Mar,378,94,82,261,259,1074,386,1419,2879,2010
291,2010-04-01,84.29,71.42,1186.69,Apr,370,103,85,254,262,1074,123,1479,2676,2010
292,2010-05-01,73.74,56.15,1089.41,May,395,88,85,254,268,1090,147,1513,2750,2010
293,2010-06-01,75.34,55.34,1030.71,Jun,388,97,84,259,271,1099,229,1531,2859,2010
294,2010-07-01,76.32,59.66,1101.6,Jul,387,98,79,273,272,1109,350,1573,3032,2010
295,2010-08-01,76.6,53.33,1049.33,Aug,388,84,84,271,275,1102,387,1638,3127,2010
296,2010-09-01,75.24,61.61,1141.2,Sep,381,94,88,276,281,1120,347,1655,3122,2010
297,2010-10-01,81.89,69.89,1183.26,Oct,377,95,83,270,274,1099,398,1668,3165,2010
298,2010-11-01,84.25,77.34,1180.55,Nov,393,100,87,274,276,1130,420,1683,3233,2010
299,2010-12-01,89.15,83.5,1257.64,Dec,385,105,79,267,282,1118,398,1711,3227,2010
300,2011-01-01,89.17,88.99,1286.12,Jan,403,117,86,269,286,1161,564,1711,3436,2011
301,2011-02-01,88.58,93.42,1327.22,Feb,412,118,94,292,273,1189,629,1718,3536,2011
302,2011-03-01,102.86,93.26,1325.83,Mar,415,118,65,288,261,1147,567,1720,3434,2011
303,2011-04-01,109.53,89.75,1363.61,Apr,402,112,72,289,254,1129,184,1790,3103,2011
304,2011-05-01,100.9,85.72,1345.2,May,410,110,82,294,255,1151,143,1836,3130,2011
305,2011-06-01,96.26,86.4,1320.64,Jun,438,113,73,290,244,1158,236,1863,3257,2011
306,2011-07-01,97.3,90.37,1292.28,Jul,438,120,61,287,244,1150,347,1900,3397,2011
307,2011-08-01,86.33,78.12,1218.89,Aug,441,128,75,287,252,1183,473,1957,3613,2011
308,2011-09-01,85.52,59.73,1131.42,Sep,432,120,78,292,252,1174,510,1978,3662,2011
309,2011-10-01,86.32,73.47,1253.3,Oct,438,122,81,297,259,1197,508,2017,3722,2011
310,2011-11-01,97.16,75.33,1246.96,Nov,422,122,86,308,247,1185,487,2011,3683,2011
311,2011-12-01,98.56,68.31,1257.6,Dec,438,112,79,304,247,1180,429,2003,3612,2011
312,2012-01-01,100.27,75.17,1312.41,Jan,420,108,78,311,254,1171,577,2003,3751,2012
313,2012-02-01,102.2,77.61,1365.68,Feb,439,120,81,311,253,1204,706,1990,3900,2012
314,2012-03-01,106.16,69.93,1408.47,Mar,438,109,89,312,244,1192,492,1979,3663,2012
315,2012-04-01,103.32,74.14,1397.91,Apr,423,118,80,312,245,1178,158,1962,3298,2012
316,2012-05-01,94.66,63.25,1310.33,May,457,118,83,318,249,1225,133,1977,3335,2012
317,2012-06-01,82.3,64.91,1362.16,Jun,435,115,106,400,229,1285,227,1972,3484,2012
318,2012-07-01,87.9,71.26,1379.32,Jul,415,110,105,401,233,1264,307,1945,3516,2012
319,2012-08-01,94.13,72.38,1406.58,Aug,417,118,111,388,227,1261,316,1913,3490,2012
320,2012-09-01,94.51,72.33,1440.67,Sep,411,124,108,381,230,1254,355,1859,3468,2012
321,2012-10-01,89.49,69.53,1412.16,Oct,412,124,104,377,242,1259,365,1834,3458,2012
322,2012-11-01,86.53,71.62,1416.18,Nov,398,127,102,394,246,1267,385,1809,3461,2012
323,2012-12-01,87.86,69.3,1426.19,Dec,414,136,102,363,238,1253,353,1784,3390,2012
324,2013-01-01,94.76,78.05,1498.11,Jan,414,134,115,379,237,1279,503,1757,3539,2013
325,2013-02-01,95.31,77.85,1514.68,Feb,427,135,113,350,250,1275,642,1762,3679,2013
326,2013-03-01,92.94,74.89,1569.19,Mar,437,133,115,336,247,1268,464,1756,3488,2013
327,2013-04-01,92.02,74.43,1597.57,Apr,429,136,125,354,257,1301,153,1755,3209,2013
328,2013-05-01,94.51,73.03,1630.74,May,424,124,124,362,249,1283,128,1767,3178,2013
329,2013-06-01,95.77,71.66,1606.28,Jun,423,138,133,389,250,1333,183,1761,3277,2013
330,2013-07-01,104.67,81.33,1685.73,Jul,418,139,128,379,241,1305,291,1766,3362,2013
331,2013-08-01,106.57,80.94,1632.97,Aug,399,143,125,362,238,1267,368,1781,3416,2013
332,2013-09-01,106.29,88.36,1681.55,Sep,404,139,119,379,243,1284,387,1760,3431,2013
333,2013-10-01,100.54,93.72,1756.54,Oct,420,136,131,383,245,1315,378,1744,3437,2013
334,2013-11-01,93.86,88.42,1805.81,Nov,411,137,135,388,240,1311,385,1756,3452,2013
335,2013-12-01,97.63,90.11,1848.36,Dec,417,126,138,405,249,1335,372,1771,3478,2013
336,2014-01-01,94.62,87.57,1782.59,Jan,401,126,139,403,256,1325,504,1769,3598,2014
337,2014-02-01,100.82,93.0,1859.45,Feb,400,132,154,396,259,1341,626,1769,3736,2014
338,2014-03-01,100.8,97.5,1872.34,Mar,406,148,132,401,258,1345,449,1803,3597,2014
339,2014-04-01,102.07,101.55,1883.95,Apr,403,151,136,407,252,1349,204,1835,3388,2014
340,2014-05-01,102.18,104.04,1923.57,May,404,149,140,414,243,1350,162,1859,3371,2014
341,2014-06-01,105.79,117.95,1960.23,Jun,398,147,123,425,251,1344,240,1861,3445,2014
342,2014-07-01,103.59,108.39,1930.67,Jul,407,153,137,432,253,1382,350,1876,3608,2014
343,2014-08-01,96.54,109.64,2003.37,Aug,410,143,125,406,255,1339,399,1904,3642,2014
344,2014-09-01,93.21,101.69,1972.29,Sep,402,148,117,396,260,1323,406,1930,3659,2014
345,2014-10-01,84.4,98.66,2018.05,Oct,393,148,125,390,252,1308,424,1925,3657,2014
346,2014-11-01,75.79,85.95,2067.56,Nov,375,149,142,403,255,1324,421,1925,3670,2014
347,2014-12-01,59.29,85.41,2058.9,Dec,369,148,138,403,255,1313,375,1882,3570,2014
348,2015-01-01,47.22,82.39,1994.99,Jan,351,128,132,415,232,1258,368,1683,3309,2015
349,2015-02-01,50.58,84.16,2104.5,Feb,355,133,132,415,240,1275,363,1348,2986,2015
350,2015-03-01,47.82,83.44,2067.89,Mar,351,135,125,407,233,1251,196,1110,2557,2015
351,2015-04-01,54.45,94.61,2085.51,Apr,325,119,120,410,228,1202,90,976,2268,2015
352,2015-05-01,59.27,90.77,2107.39,May,327,116,100,398,217,1158,80,889,2127,2015
353,2015-06-01,59.82,86.19,2063.11,Jun,314,113,103,401,215,1146,129,861,2136,2015
354,2015-07-01,50.9,82.82,2103.84,Jul,313,108,94,391,212,1118,183,866,2167,2015
355,2015-08-01,42.87,77.37,1972.18,Aug,319,109,96,393,220,1137,206,883,2226,2015
356,2015-09-01,45.48,68.97,1920.03,Sep,321,109,96,396,218,1140,183,848,2171,2015
357,2015-10-01,46.22,78.16,2079.36,Oct,294,108,93,403,213,1111,184,791,2086,2015
358,2015-11-01,42.44,77.15,2080.41,Nov,284,108,90,419,208,1109,178,760,2047,2015
359,2015-12-01,37.19,69.75,2043.94,Dec,270,114,91,422,198,1095,160,714,1969,2015
360,2016-01-01,31.68,72.27,1940.24,Jan,243,108,94,407,193,1045,192,654,1891,2016
361,2016-02-01,30.32,71.72,1932.23,Feb,237,107,88,404,182,1018,211,532,1761,2016
362,2016-03-01,37.55,73.75,2059.74,Mar,218,96,91,397,183,985,88,478,1551,2016
363,2016-04-01,40.75,80.34,2065.3,Apr,203,90,90,384,179,946,41,437,1424,2016
364,2016-05-01,46.71,76.3,2096.96,May,188,95,91,391,190,955,42,408,1405,2016
365,2016-06-01,48.76,79.08,2098.86,Jun,178,91,87,389,182,927,63,417,1407,2016
366,2016-07-01,44.65,80.52,2173.6,Jul,186,94,82,390,186,938,94,449,1481,2016
367,2016-08-01,44.72,79.0,2170.95,Aug,187,96,81,379,194,937,129,481,1547,2016
368,2016-09-01,45.18,78.64,2168.27,Sep,189,92,77,386,190,934,141,509,1584,2016
369,2016-10-01,49.78,78.23,2126.15,Oct,183,87,77,391,182,920,156,544,1620,2016
370,2016-11-01,45.66,84.05,2198.81,Nov,181,97,79,380,188,925,173,580,1678,2016
371,2016-12-01,51.97,83.95,2238.83,Dec,184,99,78,376,192,929,209,634,1772,2016
372,2017-01-01,52.5,83.71,2278.87,Jan,176,98,79,382,198,933,302,683,1918,2017
373,2017-02-01,53.47,80.36,2363.64,Feb,179,107,77,382,196,941,342,744,2027,2017
374,2017-03-01,49.33,78.1,2362.72,Mar,185,94,80,386,198,943,253,789,1985,2017
375,2017-04-01,51.06,72.59,2384.2,Apr,182,91,89,389,205,956,108,853,1917,2017
376,2017-05-01,48.48,69.59,2411.8,May,190,95,84,391,197,957,85,893,1935,2017
377,2017-06-01,45.18,65.84,2423.41,Jun,192,91,86,397,194,960,150,931,2041,2017
378,2017-07-01,46.63,68.6,2470.3,Jul,196,82,89,397,195,959,198,953,2110,2017
379,2017-08-01,48.04,63.51,2471.65,Aug,191,91,84,391,195,952,217,947,2116,2017
380,2017-09-01,49.82,69.76,2519.36,Sep,177,91,79,395,189,931,210,940,2081,2017
381,2017-10-01,51.58,64.0,2575.26,Oct,177,91,85,385,213,951,204,922,2077,2017
382,2017-11-01,56.64,62.85,2647.58,Nov,181,85,85,378,213,942,204,911,2057,2017
383,2017-12-01,57.88,67.39,2673.61,Dec,195,87,77,378,217,954,205,930,2089,2017
384,2018-01-01,63.7,73.58,2823.81,Jan,191,84,80,383,222,960,278,937,2175,2018
385,2018-02-01,62.23,65.64,2713.83,Feb,199,84,90,396,210,979,323,969,2271,2018
386,2018-03-01,62.73,64.78,2640.87,Mar,193,89,89,397,204,972,218,989,2179,2018
387,2018-04-01,66.25,68.56,2648.05,Apr,189,88,94,398,209,978,98,1011,2087,2018
388,2018-05-01,69.98,68.67,2705.27,May,174,80,94,401,218,967,83,1046,2096,2018
389,2018-06-01,67.87,67.03,2718.37,Jun,180,78,94,392,215,959,137,1056,2152,2018
390,2018-07-01,70.98,67.52,2816.29,Jul,190,80,98,400,229,997,204,1050,2251,2018
391,2018-08-01,68.06,63.16,2901.52,Aug,192,85,104,402,225,1008,220,1050,2278,2018
392,2018-09-01,70.23,60.92,2913.98,Sep,192,86,109,395,222,1004,201,1053,2258,2018
393,2018-10-01,70.75,51.31,2711.74,Oct,193,92,107,404,221,1017,192,1062,2271,2018
394,2018-11-01,56.96,45.1,2760.17,Nov,189,83,103,394,222,991,198,1077,2266,2018
395,2018-12-01,49.52,36.08,2506.85,Dec,197,95,108,394,231,1025,141,1078,2244,2018
396,2019-01-01,51.38,44.21,2704.1,Jan,195,86,109,402,232,1024,176,1065,2265,2019
397,2019-02-01,54.95,44.06,2784.49,Feb,182,94,113,398,240,1027,230,1049,2306,2019
398,2019-03-01,58.15,43.57,2834.4,Mar,188,95,127,395,234,1039,151,1023,2213,2019
399,2019-04-01,63.86,42.68,2945.83,Apr,190,98,126,412,236,1062,66,1012,2140,2019
400,2019-05-01,60.83,34.69,2752.06,May,179,186,123,410,228,1126,70,986,2182,2019
401,2019-06-01,54.66,39.74,2941.76,Jun,189,193,116,413,227,1138,114,969,2221,2019
402,2019-07-01,57.35,39.97,2980.38,Jul,201,200,111,424,226,1162,121,955,2238,2019
403,2019-08-01,54.81,32.43,2926.46,Aug,194,193,115,416,220,1138,142,926,2206,2019
404,2019-09-01,56.95,34.17,2976.74,Sep,189,176,115,425,226,1131,132,878,2141,2019
405,2019-10-01,53.96,32.69,3037.56,Oct,189,175,116,424,226,1130,145,848,2123,2019
406,2019-11-01,57.03,36.2,3140.98,Nov,196,147,116,417,220,1096,136,810,2042,2019
407,2019-12-01,59.88,40.2,3230.78,Dec,191,139,118,430,226,1104,135,804,2043,2019
408,2020-01-01,57.52,33.51,3225.52,Jan,179,133,114,430,222,1078,204,791,2073,2020
409,2020-02-01,50.54,27.09,2954.22,Feb,184,130,120,426,224,1084,249,791,2124,2020
410,2020-03-01,29.21,13.49,2584.59,Mar,169,123,108,427,231,1058,133,772,1963,2020
411,2020-04-01,16.55,16.82,2912.43,Apr,89,112,103,420,191,915,33,566,1514,2020
412,2020-05-01,28.56,18.47,3044.31,May,62,111,61,375,196,805,23,348,1176,2020
413,2020-06-01,38.31,18.39,3100.29,Jun,71,110,60,343,197,781,18,274,1073,2020
414,2020-07-01,40.71,18.14,3271.12,Jul,74,105,56,314,193,742,32,255,1029,2020
415,2020-08-01,42.34,19.01,3500.31,Aug,75,109,62,301,200,747,53,250,1050,2020
416,2020-09-01,39.63,15.56,3363.0,Sep,83,113,55,282,169,702,60,257,1019,2020
417,2020-10-01,39.4,14.94,3269.96,Oct,86,101,54,245,170,656,80,280,1016,2020
418,2020-11-01,40.94,20.79,3621.63,Nov,101,102,63,239,164,669,95,310,1074,2020
419,2020-12-01,47.02,21.83,3756.07,Dec,109,97,53,242,164,665,100,339,1104,2020
420,2021-01-01,52.0,22.21,3714.24,Jan,119,94,51,251,162,677,137,369,1183,2021
421,2021-02-01,59.04,27.91,3811.15,Feb,125,98,57,260,161,701,171,398,1270,2021
422,2021-03-01,62.33,27.19,3972.89,Mar,125,100,59,261,170,715,108,408,1231,2021
423,2021-04-01,61.72,27.05,4181.17,Apr,118,97,61,252,167,695,58,436,1189,2021
424,2021-05-01,65.17,31.33,4204.11,May,136,101,64,266,183,750,59,453,1262,2021
425,2021-06-01,71.38,32.01,4297.5,Jun,143,105,65,262,183,758,103,464,1325,2021
426,2021-07-01,72.49,28.83,4395.26,Jul,134,99,68,263,187,751,145,484,1380,2021
427,2021-08-01,67.73,28.04,4522.68,Aug,138,105,75,261,198,777,156,501,1434,2021
428,2021-09-01,71.65,29.64,4307.54,Sep,140,106,78,269,194,787,153,508,1448,2021
429,2021-10-01,81.48,32.26,4605.38,Oct,152,104,79,275,190,800,166,538,1504,2021
430,2021-11-01,79.15,28.68,4567.0,Nov,155,107,84,276,195,817,167,560,1544,2021
431,2021-12-01,71.71,29.95,4766.18,Dec,158,114,87,282,193,834,150,579,1563,2021
432,2022-01-01,83.22,39.07,4515.55,Jan,158,111,86,289,197,841,190,601,1632,2022
433,2022-02-01,91.64,39.24,4373.79,Feb,153,102,81,287,190,813,220,636,1669,2022
434,2022-03-01,108.5,41.31,4530.41,Mar,160,78,87,303,187,815,185,661,1661,2022
435,2022-04-01,101.78,39.01,4131.93,Apr,163,81,78,300,184,806,107,690,1603,2022
436,2022-05-01,109.55,45.96,4132.15,May,155,79,76,314,193,817,93,718,1628,2022
437,2022-06-01,114.84,35.76,3785.38,Jun,160,87,78,303,196,824,143,739,1706,2022
438,2022-07-01,101.62,37.03,4130.29,Jul,163,87,78,309,196,833,186,756,1775,2022
439,2022-08-01,93.67,38.15,3955.0,Aug,172,104,77,308,199,860,201,764,1825,2022
440,2022-09-01,84.26,35.9,3585.62,Sep,180,106,80,308,205,879,211,763,1853,2022
441,2022-10-01,87.55,52.03,3871.98,Oct,188,107,84,326,206,911,214,768,1893,2022
442,2022-11-01,84.37,51.55,4080.11,Nov,185,102,91,330,202,910,201,779,1890,2022
443,2022-12-01,76.44,53.46,3839.5,Dec,173,115,92,323,197,900,155,779,1834,2022
444,2023-01-01,78.12,56.98,4076.6,Jan,170,117,92,318,204,901,226,772,1899,2023
445,2023-02-01,76.83,53.21,3970.15,Feb,181,111,94,327,202,915,248,758,1921,2023
